1111111111111111111111111
1000000000000000000000001
1000000000000000000000001
1000000000000000000000001
1000000000000000000000001
1000000000000000000000221
1000000000000000000000001
1000000000000000000000001
1000000000000000000000001
1000000000000000022220001
1000000000000000000000001
1000000000000000000000001
1000000000000000000000001
1000000000000000000000221
1000000000000000000000001
1000000000000000000000001
1000000000000000000000001
1000000000000000022222001
1000000022222000000000001
1000000000000000000000001
1000000000000000000000001
1222222222222222222222221
1111111111111111111111111
1111111111111111111111111
1111111111111111111111111
